1111111111111111111111111111111111111111111111111111111111111111
1000001000001000000000000000000000000000000000000001000001000001
1000001000001000000000000000000000000000000000000001000001000001
100000100*001000000000000000000000000000000000000001000001000001
1000001000001111111111111111111111111111111111111111000001000001
1000001000000000000000000000010000000000000000000000000001000001
1000001000000000000000000000010000000000000000000000000001000001
1000001000000000000000000000010000000000000000000000000001000001
1000001000000000000000000000010000000000000000000000000001000001
1000001110000000000011111111000000000000011111111111111111000001
1000001110000000000000000000000000000000010000000000000001000001
1000001010000000000000000000000000000001111100000000000001000001
1000001000000000000000000000000000000000000000000000000001000001
1000001100000000000000000000000000000000000000000000000001000001
1000001000000000000000000000000000000000000000000000000001000001
1000001000000000000000000000000000000000010000000000000001000001
1000001000000000000000000111111111111111110000000000000001000001
1000001011111000000000000000010000000000000000000000000001000001
1000001000000000000000000000000000010000000000000000000001000001
1000001000000000000000000000000000010000000000000000000001000001
10000010000000000000000000000000000000000000-0000000000001000001
1000001000010000000000000000010000000000000000000000000001000001
1000001000010000000000000000010000010000000000000000000001000001
1000001000011111100000000011111110000001111111110000000001000001
1000001000000000100000000000000000000000000001000000000001000001
1000001000000000100000000000000000000000000000000000000001000001
1000001000000000100000000000000000000001000000000000000001000001
1000001000111111100000000000000000000000000000000000000001000001
1000001000000000000000000000111110000001111111111111000001000001
1000001000000000000000000000100000000000010000000000000001000001
1000001000000000000000000000000000000000010000000000000001000001
1000001000000000000000000000000000000000010000000000000001000001
1000001000000000000000000000000000000000010000000000000001000001
1000001011111111000000000000100000000000000000000000000001000001
1000001010000001000000000000100000000000000000000000000001000001
1000001010000001111111111111100000000000000000000000000001000001
1000001010000001000000000000000000000000000000000000000001000001
1000001010000001000000000000000000000000000000000000000001000001
1000001111111111111111111111111111111111111111111111111111000001
1000000000000000000000000000000000000000000000000000000000000001
1000000000000000000000000000000000000000000000000000000000000001
1000000000000000000000000000000000000000000000000000000000000001
1111111111111111111111111111111111111111111111111111111111111111