1111111111111111111111111111111111111111111111111111111111111111
1000000000001000000000000000000000000000000000000000000000000001
10000*0000001000000000000000000000000000000000000000000000000001
1000000000001000000000000000000000000000000000000000000000000001
1000000000001111111111111111111111111111111111111110000000000001
1000000000000000000000000000010000000000000000000000000000000001
1000000000000000000000000000010000000000000000000000000000000001
1000000000000000000000000000010000000000000000000000000000000001
1000000000000000000000000000010000000000000000000000000000000001
1000000110000000000011111111000000000000011111111111111110000001
1000000110000000000000000000000000000000010000000000000000000001
1000000010000000000000000000000000000001111100000000000000000001
100000000000000000@000000000000000000000000000000000000000000001
1000000100000000000000000000000000000000000000000000000000000001
1000000000000000000000000000000000000000000000000000000000000001
1000001000000000000000000000000000000000010000000000000000000001
1000001000000000000000000111111111111111110000000000000000000001
1000001011111000000000000000010000000000000000000000000000000001
1000001000000000000000000000000000010000000000000000000000000001
1000001000000000000000000000000000010000000000000000000000000001
10000010000000000000000000000000000000000000-0000000000000000001
1000001000010000000000000000010000000000000000000000000000000001
1000000000010000000000000000010000010000000000000000000001000001
1000000000011111100000000011111110000001111111110000000001000001
1000000000000000100000000000000000000000000001000000000001000001
1000000000000000100000000000000000000000000000000000000001000001
1000000000000000100000000000000000000001000000000000000001000001
1000000000111111100000000000000000000000000000000000000001000001
1000000000000000000000000000111110000001111111111111000001000001
1000000000000000000000000000100000000000010000000000000001000001
1000000000000000000000000000000000000000010000000000000000000001
1000000000000000000000000000000000000000010000000000000000000001
1000000000000000000000000000000000000000010000000000000000000001
1000000011111111000000000000100000000000000000000000000000000001
1000000010000001000000000000100000000000000000000000000000000001
1000000010000001111111111111100000000000000000000000000000000001
1000000010000001000000000000000000000000000000000000000000000001
1000000010000001000000000000000000000000000000000000000000000001
1000000111111111111111111110000000000000000111111111111110000001
1000000000000000000000000000000000000000000000000000000000000001
1000000000000000000000000000000000000000000000000000000000000001
1000000000000000000000000000000000000000000000000000000000000001
1111111111111111111111111111111111111111111111111111111111111111